9 9 9 9 9 9 1 1 9 9 9 9 9 9 9 9 9 9 9 9 2 2 0 0 9 9 
9 9 9 9 9 9 1 1 9 9 9 9 9 9 9 9 9 9 9 9 2 2 0 0 9 9 
9 9 9 9 9 9 0 0 9 9 0 0 9 9 0 0 9 9 9 9 2 2 0 0 9 9 
9 9 9 9 9 9 0 0 9 9 0 0 9 9 0 0 9 9 9 9 2 2 0 0 9 9 
2 2 2 2 0 0 0 0 9 9 0 0 1 1 0 0 9 9 9 9 2 2 9 9 9 9 
2 2 2 2 0 0 0 0 9 9 0 0 1 1 0 0 9 9 9 9 2 2 9 9 9 9 
9 9 9 9 0 0 0 0 9 9 1 1 9 9 9 9 1 1 2 2 2 2 9 9 9 9 
9 9 9 9 0 0 0 0 9 9 1 1 9 9 9 9 1 1 2 2 2 2 9 9 9 9 
9 9 0 0 1 1 9 9 9 9 0 0 2 2 0 0 1 1 0 0 2 2 2 2 9 9 
9 9 0 0 1 1 9 9 9 9 0 0 2 2 0 0 1 1 0 0 2 2 2 2 9 9 
0 0 0 0 9 9 9 9 1 1 0 0 2 2 9 9 9 9 9 9 0 0 0 0 0 0 
0 0 0 0 9 9 9 9 1 1 0 0 2 2 9 9 9 9 9 9 0 0 0 0 0 0 
0 0 2 2 2 2 1 1 0 0 0 0 2 2 0 0 9 9 9 9 9 9 9 9 9 9 
0 0 2 2 2 2 1 1 0 0 0 0 2 2 0 0 9 9 9 9 9 9 9 9 9 9 
2 2 0 0 9 9 0 0 9 9 0 0 9 9 0 0 9 9 0 0 1 1 0 0 3 3 
2 2 0 0 9 9 0 0 9 9 0 0 9 9 0 0 9 9 0 0 1 1 0 0 3 3 
9 9 0 0 9 9 0 0 9 9 3 3 3 3 0 0 3 3 3 3 3 3 0 0 9 9 
9 9 0 0 9 9 0 0 9 9 3 3 3 3 0 0 3 3 3 3 3 3 0 0 9 9 
9 9 0 0 0 0 0 0 9 9 0 0 1 1 0 0 3 3 2 2 2 2 0 0 9 9 
9 9 0 0 0 0 0 0 9 9 0 0 1 1 0 0 3 3 2 2 2 2 0 0 9 9 
9 9 0 0 0 0 0 0 9 9 9 9 9 9 9 9 3 3 2 2 3 3 0 0 9 9 
9 9 0 0 0 0 0 0 9 9 9 9 9 9 9 9 3 3 2 2 3 3 0 0 9 9 
9 9 9 9 9 9 9 9 9 9 9 9 9 9 9 9 3 3 2 2 3 3 0 0 9 9 
9 9 9 9 9 9 9 9 9 9 9 0 0 0 0 9 3 3 2 2 3 3 0 0 9 9 
9 9 9 9 9 9 9 9 9 9 9 0 9 9 0 9 9 9 9 9 1 1 1 1 1 1 
9 9 9 9 9 9 9 9 9 9 9 0 9 9 0 9 9 9 9 9 1 1 1 1 1 1 
